15
-----------------------------------------------------------------------------------------------------------------------------------------
--***************************************************-----------------------------*------------------------------------------------------
-----------------*----------------------------------------------------------------*------------------------------------------------------
-----------------*----------------------------------------------------------------*------------------------------------------------------
-----------------*----------------------------------------------------------------*------------------------------------------------------
-----------------*----------------------------------------------------------------*------------------------------------------------------
-----------------*----------------------------------------------------------------*------------------------------------------------------
-----------------*----------------------------------------------------------------*------------------------------------------------------
-----------------*----------------------------------------------------------------*------------------------------------------------------
-----------------*----------------------------------------------------------------*------------------------------------------------------
-----------------*----------------------------------------------------------------*------------------------------------------------------
-----------------*----------------------------------------------------------------*------------------------------------------------------
-----------------*----------------------------------------------------------******************************************-------------------
-----------------------------------------------------------------------------------------------------------------------------------------
-----------------------------------------------------------------------------------------------------------------------------------------
